XXXXXXXXXXXXXXXXXXXXX
Xmo o o XXXo o o o oX
X XoXXXoXXX XXXoXXX X
XoX oXX o o XXX XXXoX
X XX oXoXXXoXXXo o  X
XoXXX X o   o o oXXoX
X o o XXXXoXXXXXo o X
XX XXoXXXX XXXXXXXXoX
XXo o o o o oXXzo o X
XXXXXoXXXX X XXoXX XX
XXXXX XXXXoXo o XXoXX
XXXXXoXXXX XXXXXXX XX
XXo o XXX o oXXXXXoXX
Xo X o o oXX o o o oX
X XXoXXXX XXXXXXoXX X
XoXX o oXoXXXXXX XXoX
X XXXXXo  o o oXoXX X
Xo o o oXXXXXX X o oX
XXXXX XXXXXXXXoXXXX X
X> o oXf o o o o o oX
XXXXXXXXXXXXXXXXXXXXX